###############################################################################
#....................^^^......................................................#
#...................^^^^^.....................................................#
#..................^^~~~^^....................................................#
#...............^^^~~~~~~~^^^.................................................#
#..............^^^~~~~~~~^^^................D.................................#
#.......@......^^^~~~~~~~^^^..................................................#
#...............^^^~~~~~^^^...................................................#
#..........M.......^^^^^......................................................#
#....................^^^......................................................#
#.............................................................................#
#......................^^^^^^^^^^^^^^.........................................#
#.....M................^^^^^^^^^^^^^^........M................................#
#......................^^^....T...^^^.........................................#
#......................^^^........^^^.........................................#
#.............................................................................#
#.................................................#################...........#
#...............................M.................#...............#...........#
#.................................................#...............#...........#
#.................................................#...............#...........#
#.................................................#...............#...........#
#.................................................#################...........#
#.............................................................................#
#.............................................................................#
#.............................................................................#
#.............................................................................#
#.............................................................................#
#.............................................................................#
#.............................................................................#
#.............................................................................#
#.............................................................................#
#.............................................................................#
#.............................................................................#
#.............................................................................#
#.............................................................................#
#.............................................................................#
#.............................................................................#
#.............................................................................#
#.............................................................................#
#.............................................................................#
#.............................................................................#
#.............................................................................#
#.............................................................................#
#.............................................................................#
#.............................................................................#
#.............................................................................#
#.............................................................................#
#.............................................................................#
#.............................................................................#
###############################################################################